=######===
##  X ####
#   T    #
#  XCO   #
#        #
#    P   #
#    B   #
#   ~    #
# TC    E#
##########
